{
'D3220’:'',
'D3222’:'',
'D3310':'',
'D3320':'',
'D3330':'',
'D3346':'',
'D3347':'',
'D3348':'',
'D3410':'',
'D3421':'',
'D3425':'',
'D3450':''
}